*******
* * *E*
* * * *
*   * *
* * * *
* * * *
*S*   *
*******